นามสกุลของคุณเหมือนกันกับเพื่อนฉันเลย	Your surname is the same as my friend's.
จังหวัดนี้กับกรุงเทพฯคล้ายกันมาก	This province is very similar to Bangkok (Krung Thep).
ฉันจําไม่ได้ว่าเขาชื่อเล่นอะไร	I don't remember what their nickname is.
ฟังไม่ทันครับพูดอีกทีสิ	I didn't catch that, please say it again.
5: Failed คุณพูดดังๆหน่อยได้ไหม	Can you speak a bit louder?
ครูบอกให้ทุกคนพูดช้าๆ	The teacher told everyone to speak slowly.
เปิดหน้าสิบห้าแล้วพูดตาม	Turn to page fifteen and repeat after me.
ตัวอย่างเช่นมะละกอกับแก้วมังกร	For example, papaya and dragon fruit.
พักสิบนาทีแล้วเราเริ่มเรียนต่อ	Ten minute break, then we'll continue studying.
ปิดหนังสือแล้วฟังดีๆ	Close your book and listen carefully.
เขาถามว่าคุณรู้จักใครที่นั่น	He asked if you know anyone there.
ฉันคิดว่าเธออยู่ที่ไหน	I wonder where she is.
เมื่อไหร่คุณจะไปเที่ยว	When will you go traveling?
คุณทำยังไงถึงมาที่นี่	How did you get here?
ทำไมเขาไม่มาวันนี้	Why didn't he come today?
เป็นยังไงบ้างก็เรื่อยๆ	How's it going? So-so, uneventful.
เธอจะไปไหนอาทิตย์หน้า	Where are you going next week?
ฉันไม่ได้ไปไหนเลยวันนี้	I'm not going anywhere today.
ฉันไปธุระแล้วกลับมาเย็น	I'm going to run errands and will return in the evening.
ฉันไปก่อนนะแล้วเจอกันใหม่	I'm off now, see you later.
เมื่อวานนี้ฉันไปห้างกับเพื่อน	Yesterday I went to the mall with my friend.
พรุ่งนี้เราจะไปสนามบิน	Tomorrow we will go to the airport.
โรงแรมอยู่ใกล้วัดมาก	The hotel is very near the temple.
โรงพยาบาลอยู่ตรงข้ามกับตลาด	The hospital is opposite the market.
ธนาคารอยู่ระหว่างโรงหนังกับโรงเรียน	The bank is between the cinema and the school.
บริษัทของฉันอยู่แถวสถานีตำรวจ	My company is in the area around the police station.
ห้องน้ำอยู่แถวไหนครับ	Where about is the toilet?
คุณกลับบ้านตอนไหน	What time do you return home?
พอถึงไฟแดงแล้วเลี้ยวซ้าย	When you reach the traffic lights, turn left.
ตรงไปแล้วเลี้ยวขวาที่สี่แยก	Go straight then turn right at the crossroads.
กลับรถตรงสามแยกนะ	Make a U-turn at the junction.
รถจอดอยู่ใกล้สะพาน	The car is parked near the bridge.
เดินไปตามถนนนี้ประมาณสิบนาที	Walk along this road for about ten minutes.
คุณขึ้นรถเมล์สายไหน	Which bus route do you take?
ฉันลงป้ายรถเมล์ตรงนั้น	I get off at that bus stop.
ก๋วยเตี๋ยวขายยังไงครับ	How are the noodles sold?
ชามละสามสิบบาท	Thirty baht per bowl.
ใส่ไข่ด้วยนะ	With egg please.
ฉันเคยว่ายน้ำที่สระนี้	I have swam in this pool before.
เขายังไม่เสร็จทำการบ้าน	He hasn't finished doing his homework yet.
เธอชอบร้องเพลงและถ่ายรูป	She likes to sing songs and take pictures.
พวกเราทำความสะอาดบ้านด้วยกัน	We clean the house together.
ฉันออกกำลังกายทุกเช้า	I exercise every morning.
เขาสั่งข้าวเปล่ากับแกงเขียวหวาน	He ordered plain rice with green curry.
ให้น้ำเปล่าด้วยครับ	Plain water as well please.
อาหารเผ็ดเกินไปหรือเปล่า	Is the food too spicy?
รสชาติหวานและเปรี้ยวเล็กน้อย	The taste is sweet and a little sour.
แค่นี้ครับไม่เอาอะไรแล้ว	That's all, I don't want anything else.
น้ำปลากับพริกป่นอยู่ตรงไหน	Where are the fish sauce and chilli flakes?
ใส่น้ำตาลและมะนาวหน่อย	Add some sugar and lime.
ขอน้ำจิ้มหน่อยครับ	Can I have some dipping sauce please?
โทษทีครับข้าวหมดแล้ว	Sorry, the rice is finished.
มีอย่างอื่นไหมครับ	Is there anything else?
ราคาทั้งหมดเท่าไหร่	What's the total price?
ไม่ต้องทอนครับเก็บเอาไว้	Keep the change.
ฉันอยากซื้อเสื้อผ้าใหม่	I want to buy new clothes.
อยากได้แบบไหนครับ	What kind do you want?
ขอลองใส่ได้ไหม	Can I try it on?
ราคานี้แพงไปหรือเปล่า	Is this price too expensive?
ลดราคาหน่อยได้ไหม	Can you give a discount?
เสื้อตัวนี้สีแดงสวยมาก	This red shirt is very beautiful.
กางเกงขายาวคู่นี้ดูดีนะ	This pair of long trousers looks good.
รองเท้าแตะใบนี้ถูกกว่าอันนั้น	These slippers are cheaper than those ones.
ฉันชอบลายดอกและลายทาง	I like floral patterns and stripes.
หมวกสีฟ้าใบนี้น่ารัก	This sky blue hat is cute.
เนคไทเส้นนี้ยาวเกินไป	This tie is too long.
ตอนเช้าฉันตื่นนอนหกโมง	In the morning I wake up at 6 o'clock.
ฉันออกจากบ้านตอนเจ็ดโมงครึ่ง	I leave home at half past seven.
เขาเริ่มทำงานตอนแปดโมง	He starts work at 8 o'clock.
พวกเราเจอกันตอนบ่ายสามโมง	We meet at 3pm in the afternoon.
ฉันนอนตอนสองทุ่มทุกคืน	I sleep at 8pm every night.
แต่งตัวเสร็จแล้วหรือยัง	Have you finished getting dressed yet?
ฉันต้องเปลี่ยนเสื้อผ้าก่อน	I need to change clothes first.
เขาขี้ลืมมากเลย	He is very forgetful.
ใช้เวลานานเท่าไหร่	How long did it take?
วันจันทร์เราไม่ว่าง	On Monday we're not free.
คืนนี้คุณทำอะไร	What are you doing tonight?
เมื่อคืนนี้ฝนตกมาก	Last night it rained a lot.
มีอะไรเหรอที่เธอเรียกฉัน	What's the matter that you called me?
ขอคิดก่อนนะยังไม่แน่ใจ	Let me think first, I'm not sure yet.
เธอสายแล้วต้องรีบไป	You're late, you need to hurry.
ขอบใจมากนะที่ช่วย	Thank you very much for helping.
อากาศหนาวมากวันนี้	The weather is very cold today.
เขาสูงกว่าฉันนิดหน่อย	He is a bit taller than me.
งานนี้ยากแค่ไหน	How difficult is this work?
บ้านหลังนี้สะอาดมาก	This house is very clean.
ห้องนี้กว้างกว่าห้องนั้น	This room is bigger than that room.
ค่าเช่าเดือนละเท่าไหร่	How much is the rent per month?
ห้องนอนมีหน้าต่างหันไปทางตะวันออก	The bedroom has windows facing east.
ฉันกำลังหาคอนโดใหม่อยู่	I'm looking for a new condo.
ยังไม่ตัดสินใจว่าจะเช่าหรือเปล่า	I haven't decided whether to rent or not.
ห้องนั่งเล่นมีโซฟาและโต๊ะ	The living room has a sofa and table.
ระเบียงมีวิวสวนสาธารณะ	The balcony has a view of the park.
ห้องครัวมีตู้เย็นและเครื่องซักผ้า	The kitchen has a fridge and washing machine.
เตียงอยู่ข้างตู้เสื้อผ้า	The bed is beside the wardrobe.
พวกเราทำอาหารกันทุกวัน	We cook together every day.
ฉันเล่นกีฬาที่สนามกับเพื่อน	I play sports at the park with friends.
เธอดูหนังเสร็จแล้วหรือยัง	Have you finished watching the movie yet?
พวกเรารออยู่ที่ท่าเรือ	We are waiting at the pier.
เขาขับรถไปโรงเรียนทุกวัน	He drives to school every day.
ฉันขี่มอเตอร์ไซค์ไปทำงาน	I ride a motorcycle to work.
รถไฟฟ้าผ่านห้างใหญ่หลายแห่ง	The sky train passes many big malls.
เราต้องต่อรถที่สถานีนี้	We need to change transport at this station.
ฉันนั่งรถเมล์ไปทำงานทุกวัน	I take the bus to work every day.
วินมอเตอร์ไซค์อยู่ตรงไหน	Where is the motorcycle taxi stand?
เครื่องบินจะถึงกี่โมง	What time will the plane arrive?
ชั้นสามมีร้านอาหารมั้ย	Is there a restaurant on the third floor?
คุณจะเห็นซุปเปอร์ข้างขวา	You will see the supermarket on the right.
ฟิตเนสอยู่ข้างบนชั้นห้า	The gym is on the fifth floor.
ประชาสัมพันธ์อยู่ข้างในห้าง	The information point is inside the mall.
ลานจอดรถอยู่ข้างนอกตึก	The car park is outside the building.
มีอะไรให้ช่วยไหมครับ	How can I help you?
ขอบันไดเลื่อนอยู่ตรงไหน	Where are the escalators?
ลิฟต์อยู่ข้างหลังคุณ	The elevator is behind you.
ฉันเดินขึ้นบันไดไปชั้นสอง	I walk up the stairs to the second floor.
ผักชีกับต้นหอมใส่มั้ย	Do you put coriander and spring onion?
เส้นเล็กหรือเส้นใหญ่ครับ	Small thin noodles or wide thick noodles?
ให้บะหมี่แห้งกับลูกชิ้น	I'll have dry egg noodles with meatballs.
ไม่เอาผงชูรสนะ	No MSG please.
อยากได้เส้นหมี่ผัด	I want stir-fried rice vermicelli.
ปลาหมึกทอดกรอบมาก	The fried squid is very crispy.
ใส่ถั่วงอกด้วยไหม	Do you want bean sprouts with it?
น้ำส้มสายชูกับพริกไทยอยู่บนโต๊ะ	The vinegar and pepper are on the table.
ราคาข้าวหรือเป็นกับข้าว	On top of rice or as a separate dish?
อยากกินอะไรเค็มหรือหวาน	Do you want to eat something salty or sweet?
ครั้งที่แล้วฉันสั่งผัดไทย	Last time I ordered pad thai.
ปูผัดผงกะหรี่เผ็ดไหม	Is the curry crab stir fry spicy?
ฉันไม่กินเครื่องในนะ	I don't eat offal.
ปิ้งไก่กับต้มยำกุ้ง	Grilled chicken and tom yum soup with shrimp.
ยำวุ้นเส้นเปรี้ยวดี	The glass noodle salad is nicely sour.
กระเป๋าใบนี้ใส่ของได้เยอะ	This bag can hold a lot of things.
ขายกล่องละสิบบาท	Sold at ten baht per box.
ถุงพลาสติกมั้ยครับ	Do you want a plastic bag?
ดอกไม้สวยมากขอถ่ายรูปหน่อย	The flowers are very beautiful, can I take a picture?
ต้นไม้ใหญ่อยู่หน้าบ้าน	The big tree is in front of the house.
วางมือถือไว้บนโต๊ะ	Put the cell phone on the table.
เก้าอี้ตัวนี้สูงเกินไป	This chair is too tall.
เอาปากกาหรือดินสอ	Do you want a pen or pencil?
ทุเรียนราคาแพงมากตอนนี้	Durian is very expensive right now.
มังคุดหวานอร่อยมาก	Mangosteen is sweet and delicious.
เงาะกับกล้วยถูกกว่าสับปะรด	Rambutan and banana are cheaper than pineapple.
องุ่นสีม่วงหรือสีเขียว	Purple or green grapes?
น้ำมะพร้าวเย็นๆอร่อยดี	Cold coconut water is really good.
เสื้อชั้นในตัวนี้สีชมพูอ่อน	This bra is light pink.
กางเกงในคู่นี้สีดำแก่	This underwear is dark black.
กระโปรงลายจุดหรือลายตาราง	Dotted or checkered skirt?
รองเท้าสันสูงสีน้ำตาลสวย	The brown high heels are beautiful.
รองเท้าหนังคู่นี้ใหม่มาก	This pair of leather shoes is very new.
ชุดว่ายน้ำสีส้มโดนตา	The orange swimming costume is eye-catching.
กางเกงขาสั้นสีเทาอ่อน	Light gray shorts.
เสื้อเชิ้ตสีขาวแขนยาว	White long-sleeved shirt.
เสื้อยืดแขนสั้นสีเหลือง	Yellow short-sleeved T-shirt.
แว่นตาอันนี้แพงตั้งสองพันบาท	These glasses are as expensive as two thousand baht.
เข็มขัดเส้นนี้ไม่ยาวพอ	This belt is not long enough.
ที่นี่ไกลจากบ้านฉัน	Here is far from my home.
แค่สิบนาทีเองใกล้มาก	Only ten minutes, very close.
ก็แล้วกันเอาสามร้อยบาท	Let's settle for three hundred baht.
ตอนเที่ยงวันฉันกินข้าว	At noon I eat rice.
กลางคืนถนนมืดมาก	At night the road is very dark.
ตอนนี้อากาศร้อนนิดหน่อย	Right now the weather is a bit hot.
ตื่นตอนตีหนึ่งแล้วนอนไม่หลับ	Woke up at 1am and couldn't fall back asleep.
อีกสิบนาทีก็หกโมงแล้ว	In ten more minutes it will be 6 o'clock.
วันอังคารเราไปดูหนังกัน	On Tuesday let's go watch a movie together.
วันพุธฉันมีนัดกับหมอ	On Wednesday I have an appointment with the doctor.
วันพฤหัสต้องทำงานดึก	On Thursday I have to work late.
วันศุกร์คืนพรุ่งนี้ว่างมั้ย	Are you free Friday tomorrow night?
วันเสาร์เราไปเที่ยวกัน	On Saturday let's go out together.
วันอาทิตย์พักผ่อนที่บ้าน	On Sunday I rest at home.
คุณแก่กว่าฉันหรือเปล่า	Are you older than me?
เด็กคนนี้เตี้ยมาก	This child is very short.
อากาศไม่ค่อยหนาววันนี้	It's not very cold today.
งานนี้ไม่ยากเลย	This work is not difficult at all.
บ้านสกปรกต้องทำความสะอาด	The house is dirty, need to clean it.
เขาผอมลงมากเลย	He has gotten much thinner.
เธออ้วนขึ้นนิดหน่อย	She has gotten a bit fatter.
รถใหม่แพงกว่ารถเก่า	A new car is more expensive than an old car.
ห้องนี้เท่าห้องนั้นพอดี	This room is as big as that room.
ค่ามัดจำสองเดือนใช่มั้ย	The security deposit is two months, right?
หน้าต่างหันไปทางตะวันตก	The window faces west.
ตอนบ่ายแดดร้อนมาก	In the afternoon the sunlight is very hot.
ฉันดูห้องอื่นได้มั้ย	Can I look at other rooms?
ยังไม่พร้อมจะทำสัญญาเลย	Not ready to sign the contract now.
ตกลงเช่าห้องนี้แล้ว	I agree to rent this room.
สระว่ายน้ำอยู่ชั้นต่ำสุด	The swimming pool is on the lowest floor.
ชั้นหนังสือเต็มไปด้วยหนังสือเก่า	The shelves are full of old books.
เราทำอะไรด้วยกันดีไหม	Should we do something together?
ฉันจำวลีนี้ได้แล้ว	I remember this phrase already.
ออกเสียงคำนี้ยากมาก	This word is very difficult to pronounce.
คุณเคยไปโรงหนังไหม	Have you ever been to a movie theater?
พวกเขายืนขึ้นแล้วนั่งลง	They stood up and then sat down.
ครูเปิดประตูและเปิดไฟ	The teacher opened the door and turned on the light.
เขาเขียนชื่อเล่นบนกระดาน	He wrote his nickname on the board.
คุณอ่านหนังสือไทยได้หรือเปล่า	Can you read Thai books?